NO ./textures/path_to_the_north_texture.xpm 
SO ./textures/path_to_the_south_texture.xpm
WE ./textures/path_to_the_west_texture.xpm
EA ./textures/path_to_the_east_texture.xpm
F  150,200,150
C  200,200,214


111111111111
1000111
11000N10
1000000001
1111111111
