NO ./textures/path_to_the_north_texture.xpm 
SO ./textures/path_to_the_south_texture.xpm
WE ./textures/path_to_the_west_texture.xpm
EA ./textures/path_to_the_east_texture.xpm
F  150,200,150
C  200,200,214


111111111
100000001
100000001
10000N001
111111111